1111111111111111111111111111111111111
1C00000000000000000000000000000000001
1000000000000000000000000000000000001
1111111111111100000000011111111111111
1C000000000000000000000000000000000E1
1111111111111111110111111111111111111
1C00000000000000000000000000000000001
1000000000000000000000000000000000001
1000000000000000000000000000000000001
1000000000000000000000000000000000001
10000000000000000000000000000000000C1
100000000C000000000001111111111111111
1000000000000000000011111111111111111
1000000000000000000010000000000000111
1000000000000000000000000000000000111
10000000111100000000000000000000000C1
1000000011110000000010000000000000101
1000000011110000000011111111111111111
10000000111100000000000000000000000C1
1000000011110000000000111111111111111
1000000000000000000000000000000000001
1C000000000000000000000000000000000P1
1111111111111111111111111111111111111
