11111111111111111111111111111111111111111111111111111111111
100000000000000000000000000000000011111E1111100000000000001
10000000000000000000000000000000001111101111100000000000001
11111111111111111111111100000000001111101111100000000000001
11111111111111111111111100000000000000000000000000000000001
11111111111111111111111100000000000000000000000000000000001
11111111111111111111111100000000000000000000000000000000001
11111111111111111111111100000000000000000000000000000000001
11111111111111111111111100000000000000000000000000000000001
11111111111111111111111100000000000000000000000000000000001
11111111111111111111111100000000000000000000000000000000001
10000000000000000000000000000000000000000000000000000000001
10000000000000000000000000000000000000000000000000000000001
10000000000000000000000000000000000000000000000000000000001
10000000000000000000000000000000000000000000000000000000001
10000000000000000000000000000000001111111111111111111111101
10000000000000000000000000000000001111111111111111111111101
10000000000000000000000000000000001111111111111111111111101
1000000000000000000000000000000000111111C000000000000000001
10000000000000000C00000000000000001111111111111111111111101
10000000000000000000000000000000001111111111111111111111101
10000000000000000000000000000000001111111111111111111111101
10000000000000000000000000000000000000000000000000000000001
10000000000000000000000000000000000000000000000000000000001
10000000000000000000000000000000000000000000000000000000001
100000000000000000000000000000000000000000000000000000000P1
11111111111111111111111111111111111111111111111111111111111
