11111111111111111111
1E000000000000000001
10000C00000000000001
11111111111100000001
10000000000C00000001
10000000000000000001
10000C00000011111111
10000000000000000001
1P000000000000000001
11111111111111111111
