11111111111111111111
1E000000000D00000001
10000C00000000000001
11111111111100000001
1000D000000C00000001
100000000D0000000001
10000C00000011111111
10000000000000000001
10000000000D00000001
10000000000D00000001
10000C00000000000001
11111111111100000001
1000D000000C00000001
100000000D0000000001
10000C00000011111111
10000000000000000001
1P0000000000D0000001
11111111111111111111
